Date,Description,Amount,Balance
2025-01-15,AMZN,-45.67,1250.33
2025-01-16,STARBUCKS COFFEE #1234,-5.89,1244.44
2025-01-17,TRF F/ John,2500.00,3744.44
2025-01-18,NFLX Subscription,-15.99,3728.45
2025-01-19,DD VODAFONE PORTU 222111000,-52.30,3676.15
2025-01-20,Grocery Store,-89.45,3586.70